111111111
10000C001
10X000001
1P0000001
1000000E1
111111111