111111111
10000C001
100000001
1P0000001
1000000E1
111111111